{
	"0" : "০",
	"1" : "১",
	"2" : "২",
	"3" : "৩",
	"4" : "৪",
	"5" : "৫",
	"6" : "৬",
	"7" : "৭",
	"8" : "৮",
	"9" : "৯",
	"a" : "ো",
	"A" : "ও",
	"b" : "ৱ",
	"B" : "",
	"c" : "ম",
	"C" : "ণ",
	"d" : "্",
	"D" : "অ",
	"e" : "া",
	"E" : "আ",
	"f" : "ি",
	"F" : "ই",
	"g" : "ু",
	"G" : "উ",
	"h" : "প",
	"H" : "ফ",
	"i" : "গ",
	"I" : "ঘ",
	"j" : "ৰ",
	"J" : "",
	"k" : "ক",
	"K" : "খ",
	"l" : "ত",
	"L" : "থ",
	"m" : "স",
	"M" : "শ",
	"n" : "ল",
	"N" : "",
	"o" : "দ",
	"O" : "ধ",
	"p" : "জ",
	"P" : "ঝ",
	"q" : "ৌ",
	"Q" : "ঔ",
	"r" : "ী",
	"R" : "ঈ",
	"s" : "ে",
	"S" : "এ",
	"t" : "ূ",
	"T" : "ঊ",
	"u" : "হ",
	"U" : "ঙ",
	"v" : "ন",
	"V" : "",
	"w" : "ৈ",
	"W" : "ঐ",
	"x" : "ং",
	"X" : "ঁ",
	"y" : "ব",
	"Y" : "ভ",
	"z" : "",
	"Z" : "",
	"`" : "॥",
	"#":"্ৰ",
	"$":"ৰ্",
	"%":"জ্ঞ",
	"^":"ত্ৰ",
	"&":"ক্ষ",
	"*":"শ্ৰ",
	"_":"ঃ",
	"=":"ৃ",
	"+":"ঋ",
	"[":"ড",
	"{":"ঢ",
	"]":"়",
	"}":"ঞ",
	";":"চ",
	":":"ছ",
	""":"ট",
	""":"ঠ",
	"<":"ষ",
	">":"।",
	"/":"য়",
	"?":"য"
}