{
	"0" : "૦",
	"1" : "૧",
	"2" : "૨",
	"3" : "૩",
	"4" : "૪",
	"5" : "૫",
	"6" : "૬",
	"7" : "૭",
	"8" : "૮",
	"9" : "૯",
	"a" : "ો",
	"A" : "ઓ",
	"b" : "વ",
	"B" : "",
	"c" : "મ",
	"C" : "ણ",
	"d" : "્",
	"D" : "અ",
	"e" : "ા",
	"E" : "આ",
	"f" : "િ",
	"F" : "ઇ",
	"g" : "ુ",
	"G" : "ઉ",
	"h" : "પ",
	"H" : "ફ",
	"i" : "ગ",
	"I" : "ઘ",
	"j" : "ર",
	"J" : "",
	"k" : "ક",
	"K" : "ખ",
	"l" : "ત",
	"L" : "થ",
	"m" : "સ",
	"M" : "શ",
	"n" : "લ",
	"N" : "ળ",
	"o" : "દ",
	"O" : "ધ",
	"p" : "જ",
	"P" : "ઝ",
	"q" : "ૌ",
	"Q" : "ઔ",
	"r" : "ી",
	"R" : "ઈ",
	"s" : "ે",
	"S" : "એ",
	"t" : "ૂ",
	"T" : "ઊ",
	"u" : "હ",
	"U" : "ઙ",
	"v" : "ન",
	"V" : "",
	"w" : "ૈ",
	"W" : "ઐ",
	"x" : "ં",
	"X" : "ઁ",
	"y" : "બ",
	"Y" : "ભ",
	"z" : "",
	"Z" : "",
	"!" : "ઍ",
	"@" : "ૅ",
	"#":"્ર",
	"$":"ર્",
	"%":"જ્ઞ",
	"^":"ત્ર",
	"&":"ક્ષ",
	"*":"શ્ર",
	"_":"ઃ",
	"=":"ૃ",
	"+":"ઋ",
	"[":"ડ",
	"{":"ઢ",
	"]":"઼",
	"}":"ઞ",
	";":"ચ",
	":":"છ",
	""":"ટ",
	""":"ઠ",
	"<":"ષ",
	">":"।",
	"/":"ય",
	"\\":"ૉ",
	"|":"ઑ"	
}