{
	"0" : "೦",
	"1" : "೧",
	"2" : "೨",
	"3" : "೩",
	"4" : "೪",
	"5" : "೫",
	"6" : "೬",
	"7" : "೭",
	"8" : "೮",
	"9" : "೯",
	"a" : "ೋ",
	"A" : "ಓ",
	"b" : "ವ",
	"B" : "",
	"c" : "ಮ",
	"C" : "ಣ",
	"d" : "್",
	"D" : "ಅ",
	"e" : "ಾ",
	"E" : "ಆ",
	"f" : "ಿ",
	"F" : "ಇ",
	"g" : "ು",
	"G" : "ಉ",
	"h" : "ಪ",
	"H" : "ಫ",
	"i" : "ಗ",
	"I" : "ಘ",
	"j" : "ರ",
	"J" : "ಱ",
	"k" : "ಕ",
	"K" : "ಖ",
	"l" : "ತ",
	"L" : "ಥ",
	"m" : "ಸ",
	"M" : "ಶ",
	"n" : "ಲ",
	"N" : "ಳ",
	"o" : "ದ",
	"O" : "ಧ",
	"p" : "ಜ",
	"P" : "ಝ",
	"q" : "ೌ",
	"Q" : "ಔ",
	"r" : "ೀ",
	"R" : "ಈ",
	"s" : "ೇ",
	"S" : "ಏ",
	"t" : "ೂ",
	"T" : "ಊ",
	"u" : "ಹ",
	"U" : "ಙ",
	"v" : "ನ",
	"V" : "",
	"w" : "ೈ",
	"W" : "ಐ",
	"x" : "ಂ",
	"X" : "",
	"y" : "ಬ",
	"Y" : "ಭ",
	"z" : "ೆ",
	"Z" : "ಎ",
	"`" : "ೊ",
	"~" : "ಒ",
	"#":"್ರ",
	"$":"ರ್",
	"%":"ಜ್ಞ",
	"^":"ತ್ರ",
	"&":"ಕ್ಷ",
	"*":"ಶ್ರ",
	"_":"ಃ",
	"=":"ೃ",
	"+":"ಋ",
	"[":"ಡ",
	"{":"ಢ",
	"]":"",
	"}":"ಞ",
	";":"ಚ",
	":":"ಛ",
	""":"ಟ",
	""":"ಠ",
	"<":"ಷ",
	">":"|",
	"/":"ಯ"
}