{
	"0" : "൦",
	"1" : "൧",
	"2" : "൨",
	"3" : "൩",
	"4" : "൪",
	"5" : "൫",
	"6" : "൬",
	"7" : "൭",
	"8" : "൮",
	"9" : "൯",
	"a" : "ോ",
	"A" : "ഓ",
	"b" : "വ",
	"B" : "ഴ",
	"c" : "മ",
	"C" : "ണ",
	"d" : "്",
	"D" : "അ",
	"e" : "ാ",
	"E" : "ആ",
	"f" : "ി",
	"F" : "ഇ",
	"g" : "ു",
	"G" : "ഉ",
	"h" : "പ",
	"H" : "ഫ",
	"i" : "ഗ",
	"I" : "ഘ",
	"j" : "ര",
	"J" : "റ",
	"k" : "ക",
	"K" : "ഖ",
	"l" : "ത",
	"L" : "ഥ",
	"m" : "സ",
	"M" : "ശ",
	"n" : "ല",
	"N" : "ള",
	"o" : "ദ",
	"O" : "ധ",
	"p" : "ജ",
	"P" : "ഝ",
	"q" : "ൌ",
	"Q" : "ഔ",
	"r" : "ീ",
	"R" : "ഈ",
	"s" : "േ",
	"S" : "ഏ",
	"t" : "ൂ",
	"T" : "ഊ",
	"u" : "ഹ",
	"U" : "ങ",
	"v" : "ന",
	"V" : "",
	"w" : "ൈ",
	"W" : "ഐ",
	"x" : "ം",
	"X" : "",
	"y" : "ബ",
	"Y" : "ഭ",
	"z" : "െ",
	"Z" : "എ",
	"`" : "ൊ",
	"~" : "ഒ",
	"#":"്ര",
	"&":"ക്ഷ",
	"_":"ഃ",
	"=":"ൃ",
	"+":"ഋ",
	"[":"ഡ",
	"{":"ഢ",
	"]":"",
	"}":"ഞ",
	";":"ച",
	":":"ഛ",
	""":"ട",
	""":"ഠ",
	"<":"ഷ",
	">":"",
	"/":"യ"
}