{
	"0" : "୦",
	"1" : "୧",
	"2" : "୨",
	"3" : "୩",
	"4" : "୪",
	"5" : "୫",
	"6" : "୬",
	"7" : "୭",
	"8" : "୮",
	"9" : "୯",
	"a" : "ୋ",
	"A" : "ଓ",
	"b" : "ବ",
	"B" : "",
	"c" : "ମ",
	"C" : "ଣ",
	"d" : "୍",
	"D" : "ଅ",
	"e" : "ା",
	"E" : "ଆ",
	"f" : "ି",
	"F" : "ଇ",
	"g" : "ୁ",
	"G" : "ଉ",
	"h" : "ପ",
	"H" : "ଫ",
	"i" : "ଗ",
	"I" : "ଘ",
	"j" : "ର",
	"J" : "",
	"k" : "କ",
	"K" : "ଖ",
	"l" : "ତ",
	"L" : "ଥ",
	"m" : "ସ",
	"M" : "ଶ",
	"n" : "ଲ",
	"N" : "ଳ",
	"o" : "ଦ",
	"O" : "ଧ",
	"p" : "ଜ",
	"P" : "ଝ",
	"q" : "ୌ",
	"Q" : "ଔ",
	"r" : "ୀ",
	"R" : "ଈ",
	"s" : "େ",
	"S" : "ଏ",
	"t" : "ୂ",
	"T" : "ଊ",
	"u" : "ହ",
	"U" : "ଙ",
	"v" : "ନ",
	"V" : "",
	"w" : "ୈ",
	"W" : "ଐ",
	"x" : "ଂ",
	"X" : "ଁ",
	"y" : "ବ",
	"Y" : "ଭ",
	"z" : "ୟ",
	"Z" : "ୱ",
	"#":"୍ର",
	"$":"ର୍",
	"%":"ଜ୍ଞ",
	"^":"ତ୍ର",
	"&":"କ୍ଷ",
	"*":"ଶ୍ର",
	"_":"ଃ",
	"=":"ୃ",
	"+":"ଋ",
	"[":"ଡ",
	"{":"ଢ",
	"]":"଼",
	"}":"ଞ",
	";":"ଚ",
	":":"ଛ",
	""":"ଟ",
	""":"ଠ",
	"<":"ଷ",
	">":"",
	"/":"ଯ",
	"?":"ଯ଼"
}