{
	"0" : "੦", 
	"1" : "੧",
	"2" : "੨",
	"3" : "੩",
	"4" : "੪",
	"5" : "੫",
	"6" : "੬",
	"7" : "੭",
	"8" : "੮",
	"9" : "੯",
	"a" : "ੋ",
	"A" : "ਓ",
	"b" : "ਵ",
	"B" : "ੲ",
	"c" : "ਮ",
	"C" : "ਣ",
	"d" : "੍",
	"D" : "ਅ",
	"e" : "ਾ",
	"E" : "ਆ",
	"f" : "ਿ",
	"F" : "ਇ",
	"g" : "ੁ",
	"G" : "ਉ",
	"h" : "ਪ",
	"H" : "ਫ",
	"i" : "ਗ",
	"I" : "ਘ",
	"j" : "ਰ",
	"J" : "ੜ",
	"k" : "ਕ",
	"K" : "ਖ",
	"l" : "ਤ",
	"L" : "ਥ",
	"m" : "ਸ",
	"M" : "ਸ਼",
	"n" : "ਲ",
	"N" : "ਲ਼",
	"o" : "ਦ",
	"O" : "ਧ",
	"p" : "ਜ",
	"P" : "ਝ",
	"q" : "ੌ",
	"Q" : "ਔ",
	"r" : "ੀ",
	"R" : "ਈ",
	"s" : "ੇ",
	"S" : "ਏ",
	"t" : "ੂ",
	"T" : "ਊ",
	"u" : "ਹ",
	"U" : "ਙ",
	"v" : "ਨ",
	"V" : "",
	"w" : "ੈ",
	"W" : "ਐ",
	"x" : "ੰ",
	"X" : "ਂ",
	"y" : "ਬ",
	"Y" : "ਭ",
	"z" : "",
	"Z" : "",
	"~" : "੍ਹ",
	"!" : "੍ਵ",
	"@" : "੍ਯ",
	"#":"੍ਰ",
	"$":"ੱ",
	"[":"ਡ",
	"{":"ਢ",
	"]":"਼",
	"}":"ਞ",
	";":"ਚ",
	":":"ਛ",
	""":"ਟ",
	""":"ਠ",
	"<":"",
	">":"।",
	"/":"ਯ"
}