{
	"0" : "०",
	"1" : "१",
	"2" : "२",
	"3" : "३",
	"4" : "૪",
	"5" : "५",
	"6" : "६",
	"7" : "७",
	"8" : "८",
	"9" : "९",
	"a" : "ो",
	"A" : "ओ",
	"b" : "व",
	"B" : "ऴ",
	"c" : "म",
	"C" : "ण",
	"d" : "्",
	"D" : "अ",
	"e" : "ा",
	"E" : "आ",
	"f" : "ि",
	"F" : "इ",
	"g" : "ु",
	"G" : "उ",
	"h" : "प",
	"H" : "फ",
	"i" : "ग",
	"I" : "घ",
	"j" : "र",
	"J" : "ऱ",
	"k" : "क",
	"K" : "ख",
	"l" : "त",
	"L" : "थ",
	"m" : "स",
	"M" : "श",
	"n" : "ल",
	"N" : "ळ",
	"o" : "द",
	"O" : "ध",
	"p" : "ज",
	"P" : "झ",
	"q" : "ौ",
	"Q" : "औ",
	"r" : "ी",
	"R" : "ई",
	"s" : "े",
	"S" : "ए",
	"t" : "ू",
	"T" : "ऊ",
	"u" : "ह",
	"U" : "ङ",
	"v" : "न",
	"V" : "ऩ",
	"w" : "ै",
	"W" : "ऐ",
	"x" : "ं",
	"X" : "ँ",
	"y" : "ब",
	"Y" : "भ",
	"z" : "ॆ",
	"Z" : "ऎ",
	"`" : "ॊ",
	"~" : "ऒ",
	"!" : "ऍ",
	"@" : "ॅ",
	"#":"्र",
	"$":"र्",
	"%":"ज्ञ",
	"^":"त्र",
	"&":"क्ष",
	"*":"श्र",
	"_":"ः",
	"=":"ृ",
	"+":"ऋ",
	"[":"ड",
	"{":"ढ",
	"]":"़",
	"}":"ञ",
	";":"च",
	":":"छ",
	""":"ट",
	""":"ठ",
	"<":"ष",
	">":"।",
	"/":"य",
	"?":"य़",
	"\\":"ॉ",
	"|":"ऑ"
}