{
	"0" : "௦",
	"1" : "௧",
	"2" : "௨",
	"3" : "௩",
	"4" : "௪",
	"5" : "௫",
	"6" : "௬",
	"7" : "௭",
	"8" : "௮",
	"9" : "௯",
	"a" : "ோ",
	"A" : "ஓ",
	"b" : "வ",
	"B" : "ழ",
	"c" : "ம",
	"C" : "ண",
	"d" : "்",
	"D" : "அ",
	"e" : "ா",
	"E" : "ஆ",
	"f" : "ி",
	"F" : "இ",
	"g" : "ு",
	"G" : "உ",
	"h" : "ப",
	"H" : "ப",
	"i" : "க",
	"I" : "க",
	"j" : "ர",
	"J" : "ற",
	"k" : "க",
	"K" : "க",
	"l" : "த",
	"L" : "த",
	"m" : "ஸ",
	"M" : "ஷ",
	"n" : "ல",
	"N" : "ள",
	"o" : "த",
	"O" : "த",
	"p" : "ஜ",
	"P" : "ச",
	"q" : "ௌ",
	"Q" : "ஔ",
	"r" : "ீ",
	"R" : "ஈ",
	"s" : "ே",
	"S" : "ஏ",
	"t" : "ூ",
	"T" : "ஊ",
	"u" : "ஹ",
	"U" : "ங",
	"v" : "ந",
	"V" : "ன",
	"w" : "ை",
	"W" : "ஐ",
	"x" : "",
	"X" : "",
	"y" : "ப",
	"Y" : "ப",
	"z" : "ெ",
	"Z" : "எ",
	"`" : "ொ",
	"~" : "ஒ",
	"^":"த்ர",
	"&":"க்ஷ",
	"*":"ஷ்ர",
	"_":"ஃ",
	"[":"ட",
	"{":"ட",
	"]":"ஞ",
	"}":"ஞ",
	";":"ச",
	":":"ச",
	""":"ட",
	""":"ட",
	"<":"ஷ",
	">":"ஸ்ரீ",
	"/":"ய",
	"?":"ய"
}