{
	"0" : "౦",
	"1" : "౧",
	"2" : "౨",
	"3" : "౩",
	"4" : "౪",
	"5" : "౫",
	"6" : "౬",
	"7" : "౭",
	"8" : "౮",
	"9" : "౯",
	"a" : "ో",
	"A" : "ఓ",
	"b" : "వ",
	"B" : "",
	"c" : "మ",
	"C" : "ణ",
	"d" : "్",
	"D" : "అ",
	"e" : "ా",
	"E" : "ఆ",
	"f" : "ి",
	"F" : "ఇ",
	"g" : "ు",
	"G" : "ఉ",
	"h" : "ప",
	"H" : "ఫ",
	"i" : "గ",
	"I" : "ఘ",
	"j" : "ర",
	"J" : "ఱ",
	"k" : "క",
	"K" : "ఖ",
	"l" : "త",
	"L" : "థ",
	"m" : "స",
	"M" : "శ",
	"n" : "ల",
	"N" : "ళ",
	"o" : "ద",
	"O" : "ధ",
	"p" : "జ",
	"P" : "ఝ",
	"q" : "ౌ",
	"Q" : "ఔ",
	"r" : "ీ",
	"R" : "ఈ",
	"s" : "ే",
	"S" : "ఏ",
	"t" : "ూ",
	"T" : "ఊ",
	"u" : "హ",
	"U" : "ఙ",
	"v" : "న",
	"V" : "న",
	"w" : "ై",
	"W" : "ఐ",
	"x" : "ం",
	"X" : "ఁ",
	"y" : "బ",
	"Y" : "భ",
	"z" : "ె",
	"Z" : "ఎ",
	"`" : "ొ",
	"~" : "ఒ",
	"#":"్ర",
	"%":"జ్ఞ",
	"^":"త్ర",
	"&":"క్ష",
	"*":"శ్ర",
	"_":"ః",
	"=":"ృ",
	"+":"ఋ",
	"[":"డ",
	"{":"ఢ",
	"}":"ఞ",
	";":"చ",
	":":"ఛ",
	""":"ట",
	""":"ఠ",
	"<":"ష",
	"/":"య"
}